Icon	Brawler	Eigenschaft	Seltenheit
Brawlstars_Jessie	Jessie	Kontrolle	Superselten (blau)
Brawlstars_Dynamike	Dynamike	Artillerie	Superselten (blau)
Brawlstars_Piper	Piper	Schützin	Episch (lila)
Brawlstars_Edgar	Edgar	Assassine	Episch (lila)
Brawlstars_Colette	Colette	Damage-Dealerin	Episch (lila)
Brawlstars_Larry_&_Lawrie	Larry & Lawrie	Artillerie	Episch (lila)
Brawlstars_Angelo	Angelo	Schütze 	Episch (lila)
Brawlstars_Frank	Frank	Tank	Episch (lila)
Brawl-Stars-Alli	Alli	Assassine	Mythisch (rot)
Brawlstars_Buzz	Buzz	Assassine	Mythisch (rot)
Brawlstars_Fang	Fang	Assassine 	Mythisch (rot)
Brawlstars_Spike	Spike	Damage-Dealer	Legendär (gelb)
Brawlstars_Leon	Leon	Assassine 	Legendär (gelb)
Brawlstars_Surge	Surge	Damage-Dealer	Legendär (gelb)
Brawlstars_Cordelius	Cordelius	Assassine	Legendär (gelb)
Brawlstars_Kit	Kit	Unterstützer	Legendär (gelb)
Brawl-Stars-Kenji	Kenji 	Assassine	Legendär (gelb)
A-Tier
Icon	Brawler	Eigenschaft	Seltenheit
Brawlstars_Shelly	Shelly	Damage-Dealerin	Erster Brawler
Brawlstars_Colt	Colt	Damage-Dealer	Selten (grün)
Brawlstars_Brock	Brock	Schütze	Selten (grün)
Brawlstars_Tick	Tick	Artillerie	Superselten (blau)
Brawlstars_Rico	Rico	Damage-Dealer	Superselten (blau)
Brawlstars_Jacky	Jacky	Tank	Superselten (blau)
Brawlstars_Bo	Bo	Kontrolle	Episch (lila)
Brawlstars_Emz	EMZ	Kontrolle	Episch (lila)
Brawlstars_Stu	Stu	Assassine 	Episch (lila)
Brawlstars_Nani	Nani	Schützin	Episch (lila)
Brawlstars_Griff	Griff	Kontrolle	Episch (lila)
	Gale	Kontrolle	Episch (lila)
Brawlstars_Mandy	Mandy	Schützin	Episch (lila)
Brawl-Stars-Berry	Berry	Unterstützer	Episch (lila)
Brawl-Stars-Shade	Shade 	Assassine	Episch (lila)
Brawlstars_Mortis	Mortis	Assassine	Mythisch (rot)
Brawl-Stars-Clancy	Clancy	Damage-Dealer	Mythisch (rot)
Brawlstars_Gene	Gene	Kontrolle	Mythisch (rot)
Brawlstars_Lou	Lou	Kontrolle	Mythisch (rot)
Brawlstars_Eve	Eve	Damage-Dealerin	Mythisch (rot)
Brawl-Stars-Lumi	Lumi 	Damage-Dealerin	Mythisch (rot)
Brawlstars_Buster	Buster	Tank	Mythisch (rot)
Brawlstars_Mico	Mico	Assassine	Mythisch (rot)
Brawl-Stars-Melodie	Melodie	Assassine	Mythisch (rot)
Brawl-Stars-Lily	Lily	Assassine	Mythisch (rot)
Brawl-Stars-Moe	Moe	Damage-Dealer	Mythisch (rot)
Brawl-Stars-Juju	Juju 	Artillerie	Mythisch (rot)
Brawl-Stars-Ollie	Ollie 	Tank	Mythisch (rot)
Brawlstars_Crow	Crow	Assassine	Legendär (gelb)
Brawlstars_Chester	Chester	Damage-Dealer	Legendär (gelb)
Brawl-Stars-Draco	Draco	Tank	Legendär (gelb)
Brawlstars_Sandy	Sandy	Kontrolle	Legendär (gelb)
Brawl-Stars-Kaze	Kaze (NEU)	Assassine	Ultralegendär (polychrom)
B-Tier
Icon	Brawler	Eigenschaft	Seltenheit
Brawlstars_Nita	Nita	Damage-Dealerin	Selten (grün)
Brawlstars_Bull	Bull	Tank	Selten (grün)
Brawlstars_Poco	Poco	Unterstützer	Selten (grün)
Brawlstars_Rosa	Rosa	Tank	Selten (grün)
Brawlstars_8-Bit	8-Bit	Damage-Dealer	Superselten (blau)
Brawlstars_Penny	Penny	Artillerie	Superselten (blau)
Brawlstars_Gus	Gus	Unterstützer	Superselten (blau)
Brawl-Stars-Trunk	Trunk (NEU)	Tank	Episch (lila)
Brawlstars_Pam	Pam	Unterstützerin	Episch (lila)
Brawlstars_Bibi	Bibi	Tank	Episch (lila)
Brawlstars_Bea	Bea	Schützin	Episch (lila)
Brawlstars_Grom	Grom	Artillerie	Episch (lila)
Brawlstars_Belle	Belle	Schützin	Episch (lila)
Brawlstars_Lola	Lola	Damage-Dealerin	Episch (lila)
Brawlstars_Sam	Sam	Assassine	Episch (lila)
Brawlstars_Maisie	Maisie	Schützin	Episch (lila)
Brawlstars_Pearl	Pearl 	Damage-Dealerin	Episch (lila)
Brawl-Stars-Meeple	Meeple	Kontrolle	Episch (lila)
Brawlstars_Tara	Tara	Damage-Dealerin	Mythisch (rot)
Brawl-Stars-Jae-Yong	Jae-Yong	Unterstützer	Mythisch (rot)
Brawl-Stars-Finx	Finx	Kontrolle	Mythisch (rot)
Brawlstars_Max	Max	Unterstützerin	Mythisch (rot)
Brawlstars_Mr	Mr.P	Kontrolle 	Mythisch (rot)
Brawlstars_Sprout	Sprout	Artillerie	Mythisch (rot)
Brawlstars_Janet	Janet	Schützin	Mythisch (rot)
Brawlstars_Otis	Otis	Kontrolle	Mythisch (rot)
Brawlstars_Gray	Gray	Unterstützer 	Mythisch (rot)
Brawlstars_Willow	Willow	Kontrolle	Mythisch (rot)
Brawlstars_Chuck	Chuck	Damage-Dealer	Mythisch (rot)
Brawlstars_Charlie	Charlie	Kontrolle	Mythisch (rot)
Brawlstars_Doug	Doug	Unterstützer	Mythisch (rot)
Brawlstars_R-T	R-T	Damage-Dealer	Mythisch (rot)
Brawlstars_Amber	Amber	Kontrolle	Legendär (gelb)
C-Tier
Icon	Brawler	Eigenschaft	Seltenheit
Brawlstars_El_Primo	El Primo	Tank	Selten (grün)
Brawlstars_Barley	Barley	Artillerie 	Selten (grün)
Brawlstars_Darryl	Darryl	Tank	Superselten (blau)
Brawlstars_Carl	Carl	Damage-Dealer	Superselten (blau)
Brawlstars_Bonny	Bonnie	Schützin	Episch (lila)
Brawlstars_Ash	Ash	Tank	Episch (lila)
Brawlstars_Hank	Hank	Tank	Episch (lila)
Brawlstars_Byron	Byron	Unterstützer	Mythisch (rot)
Brawlstars_Squeak	Squeak	Kontrolle	Mythisch (rot)
Brawlstars_Ruffs	Ruffs	Unterstützer	Mythisch (rot)
Brawlstars_Meg	Meg	Tank	Legendär (gelb)